############################
#                          #
#   ####             ####  #
#   #  #             #  #  #
#   #  #             #  #  #
#   ####             ####  #
#                          #
#                          #
#            ##            #
#    P       ##            #
#            ##            #
#            ##            #
#                          #
#                          #
#    ###################   #
#                          #
#                          #
############################
