#########################
#                       #
#                       #
#                       #
#    @@           @@    #
#    @@           @@    #
#                       #
#                       #
#                       #
#                       #
############ ############
#                       #
#  @@@@                 #
#                       #
#                       #
#                       #
#                       #
#   P                   #
#                       #
#  ######################
#  @@@@@@@@@@@@@@@@@@@@@#
#                       #
#  @ @@@@@@@@@@   @@@@  #
#  @ @@@@@@@  @   @@@@  #
#  @ @@@@@@@  @   @@@@  #
#  @ @@@@@@@  @   @@@@  #
#  @ @@@@@@@  @@@@@@@@  #
#  @ @@@@@@@  @@@@@@@@  #
#  @          @@@@@@@@  #
######################  #
#                       #
#                       #
#                       #
#    @@  @@@@@@   @@    #
#    @@  @@@@@@   @@    #
#                       #
#                       #
#                       #
#                       #
#########################
