############################
#                          #
#                    @@@@  #
#    @@              @@@@  #
#    @@              @@@@  #
#                    @@@@  #
#                          #
#                          #
#            @@            #
#    P       @@            #
#            @@            #
#            @@            #
#                          #
#                          #
#    @@@@@@@@@@@@@@@@@@@   #
#                          #
#                          #
############################
