#########################
#                       #
#                       #
#                       #
#    @@           @@    #
#    @@           @@    #
#                       #
#                       #
#                       #
#                       #
############ ############
#                       #
#                       #
#                       #
#                       #
#         P             #
#                       #
#                       #
#                       #
#########################
